F001-AACCTCTC	AATGATACGGCGACCACCGAGATCTACACAACCTCTCACACTCTTTCCCTACACGACGCTCTTCCGATCT
F002-CGATGGTA	AATGATACGGCGACCACCGAGATCTACACCGATGGTAACACTCTTTCCCTACACGACGCTCTTCCGATCT
F003-TGAAGTCG	AATGATACGGCGACCACCGAGATCTACACTGAAGTCGACACTCTTTCCCTACACGACGCTCTTCCGATCT
F004-TCCATGGT	AATGATACGGCGACCACCGAGATCTACACTCCATGGTACACTCTTTCCCTACACGACGCTCTTCCGATCT
F005-CTTCAACC	AATGATACGGCGACCACCGAGATCTACACCTTCAACCACACTCTTTCCCTACACGACGCTCTTCCGATCT
F006-CAAGTCAT	AATGATACGGCGACCACCGAGATCTACACCAAGTCATACACTCTTTCCCTACACGACGCTCTTCCGATCT
F007-GTGACTCT	AATGATACGGCGACCACCGAGATCTACACGTGACTCTACACTCTTTCCCTACACGACGCTCTTCCGATCT
F008-ACTGGAAC	AATGATACGGCGACCACCGAGATCTACACACTGGAACACACTCTTTCCCTACACGACGCTCTTCCGATCT
F009-AACCTAGG	AATGATACGGCGACCACCGAGATCTACACAACCTAGGACACTCTTTCCCTACACGACGCTCTTCCGATCT
F010-CTGTGTAC	AATGATACGGCGACCACCGAGATCTACACCTGTGTACACACTCTTTCCCTACACGACGCTCTTCCGATCT
F011-TGGAGACA	AATGATACGGCGACCACCGAGATCTACACTGGAGACAACACTCTTTCCCTACACGACGCTCTTCCGATCT
F012-ATGGAAGA	AATGATACGGCGACCACCGAGATCTACACATGGAAGAACACTCTTTCCCTACACGACGCTCTTCCGATCT
F013-GATCACCA	AATGATACGGCGACCACCGAGATCTACACGATCACCAACACTCTTTCCCTACACGACGCTCTTCCGATCT
F014-GTCTCGTT	AATGATACGGCGACCACCGAGATCTACACGTCTCGTTACACTCTTTCCCTACACGACGCTCTTCCGATCT
F015-CCTACGTT	AATGATACGGCGACCACCGAGATCTACACCCTACGTTACACTCTTTCCCTACACGACGCTCTTCCGATCT
F016-ACACACAC	AATGATACGGCGACCACCGAGATCTACACACACACACACACTCTTTCCCTACACGACGCTCTTCCGATCT
F017-TGCAAGGA	AATGATACGGCGACCACCGAGATCTACACTGCAAGGAACACTCTTTCCCTACACGACGCTCTTCCGATCT
F018-TGTCTTGG	AATGATACGGCGACCACCGAGATCTACACTGTCTTGGACACTCTTTCCCTACACGACGCTCTTCCGATCT
F019-CTTCACAT	AATGATACGGCGACCACCGAGATCTACACCTTCACATACACTCTTTCCCTACACGACGCTCTTCCGATCT
F020-GAACACGT	AATGATACGGCGACCACCGAGATCTACACGAACACGTACACTCTTTCCCTACACGACGCTCTTCCGATCT
F021-GGATGTCT	AATGATACGGCGACCACCGAGATCTACACGGATGTCTACACTCTTTCCCTACACGACGCTCTTCCGATCT
F022-GTAGGAAG	AATGATACGGCGACCACCGAGATCTACACGTAGGAAGACACTCTTTCCCTACACGACGCTCTTCCGATCT
F023-TCCTCATC	AATGATACGGCGACCACCGAGATCTACACTCCTCATCACACTCTTTCCCTACACGACGCTCTTCCGATCT
F024-AAGAGGAA	AATGATACGGCGACCACCGAGATCTACACAAGAGGAAACACTCTTTCCCTACACGACGCTCTTCCGATCT
F025-AGGTTGAG	AATGATACGGCGACCACCGAGATCTACACAGGTTGAGACACTCTTTCCCTACACGACGCTCTTCCGATCT
F026-ACACGATC	AATGATACGGCGACCACCGAGATCTACACACACGATCACACTCTTTCCCTACACGACGCTCTTCCGATCT
F027-GAACGTAG	AATGATACGGCGACCACCGAGATCTACACGAACGTAGACACTCTTTCCCTACACGACGCTCTTCCGATCT
F028-TCAGACGA	AATGATACGGCGACCACCGAGATCTACACTCAGACGAACACTCTTTCCCTACACGACGCTCTTCCGATCT
F029-CTGTCTCA	AATGATACGGCGACCACCGAGATCTACACCTGTCTCAACACTCTTTCCCTACACGACGCTCTTCCGATCT
F030-TCTGAAGT	AATGATACGGCGACCACCGAGATCTACACTCTGAAGTACACTCTTTCCCTACACGACGCTCTTCCGATCT
F031-AACACAAG	AATGATACGGCGACCACCGAGATCTACACAACACAAGACACTCTTTCCCTACACGACGCTCTTCCGATCT
F032-TTCTCCTA	AATGATACGGCGACCACCGAGATCTACACTTCTCCTAACACTCTTTCCCTACACGACGCTCTTCCGATCT
F033-CCTACAAG	AATGATACGGCGACCACCGAGATCTACACCCTACAAGACACTCTTTCCCTACACGACGCTCTTCCGATCT
F034-TAGTGACT	AATGATACGGCGACCACCGAGATCTACACTAGTGACTACACTCTTTCCCTACACGACGCTCTTCCGATCT
F035-AGTACGTA	AATGATACGGCGACCACCGAGATCTACACAGTACGTAACACTCTTTCCCTACACGACGCTCTTCCGATCT
F036-TTGCATCC	AATGATACGGCGACCACCGAGATCTACACTTGCATCCACACTCTTTCCCTACACGACGCTCTTCCGATCT
F037-CTTGAAGG	AATGATACGGCGACCACCGAGATCTACACCTTGAAGGACACTCTTTCCCTACACGACGCTCTTCCGATCT
F038-GCACTTGT	AATGATACGGCGACCACCGAGATCTACACGCACTTGTACACTCTTTCCCTACACGACGCTCTTCCGATCT
F039-AACCAGAG	AATGATACGGCGACCACCGAGATCTACACAACCAGAGACACTCTTTCCCTACACGACGCTCTTCCGATCT
F040-ACCATCCA	AATGATACGGCGACCACCGAGATCTACACACCATCCAACACTCTTTCCCTACACGACGCTCTTCCGATCT
F041-GCTTGTGT	AATGATACGGCGACCACCGAGATCTACACGCTTGTGTACACTCTTTCCCTACACGACGCTCTTCCGATCT
F042-TGTCAAGC	AATGATACGGCGACCACCGAGATCTACACTGTCAAGCACACTCTTTCCCTACACGACGCTCTTCCGATCT
F043-ATCTCACC	AATGATACGGCGACCACCGAGATCTACACATCTCACCACACTCTTTCCCTACACGACGCTCTTCCGATCT
F044-ATCAGAGG	AATGATACGGCGACCACCGAGATCTACACATCAGAGGACACTCTTTCCCTACACGACGCTCTTCCGATCT
F045-CGAGTGAA	AATGATACGGCGACCACCGAGATCTACACCGAGTGAAACACTCTTTCCCTACACGACGCTCTTCCGATCT
F046-CAGAGCTT	AATGATACGGCGACCACCGAGATCTACACCAGAGCTTACACTCTTTCCCTACACGACGCTCTTCCGATCT
F047-CTAGAGAC	AATGATACGGCGACCACCGAGATCTACACCTAGAGACACACTCTTTCCCTACACGACGCTCTTCCGATCT
F048-AACGACTG	AATGATACGGCGACCACCGAGATCTACACAACGACTGACACTCTTTCCCTACACGACGCTCTTCCGATCT
F049-GATCATGG	AATGATACGGCGACCACCGAGATCTACACGATCATGGACACTCTTTCCCTACACGACGCTCTTCCGATCT
F050-ACGATGAC	AATGATACGGCGACCACCGAGATCTACACACGATGACACACTCTTTCCCTACACGACGCTCTTCCGATCT
F051-TTGGTCCA	AATGATACGGCGACCACCGAGATCTACACTTGGTCCAACACTCTTTCCCTACACGACGCTCTTCCGATCT
F052-ACCTGATG	AATGATACGGCGACCACCGAGATCTACACACCTGATGACACTCTTTCCCTACACGACGCTCTTCCGATCT
F053-CGATGTAG	AATGATACGGCGACCACCGAGATCTACACCGATGTAGACACTCTTTCCCTACACGACGCTCTTCCGATCT
F054-CTTCTCTC	AATGATACGGCGACCACCGAGATCTACACCTTCTCTCACACTCTTTCCCTACACGACGCTCTTCCGATCT
F055-ACAGCTGT	AATGATACGGCGACCACCGAGATCTACACACAGCTGTACACTCTTTCCCTACACGACGCTCTTCCGATCT
F056-GATCAGTC	AATGATACGGCGACCACCGAGATCTACACGATCAGTCACACTCTTTCCCTACACGACGCTCTTCCGATCT
F057-CTGTTCAG	AATGATACGGCGACCACCGAGATCTACACCTGTTCAGACACTCTTTCCCTACACGACGCTCTTCCGATCT
F058-TGTCGTCT	AATGATACGGCGACCACCGAGATCTACACTGTCGTCTACACTCTTTCCCTACACGACGCTCTTCCGATCT
F059-TGAACACC	AATGATACGGCGACCACCGAGATCTACACTGAACACCACACTCTTTCCCTACACGACGCTCTTCCGATCT
F060-CTTGTGAG	AATGATACGGCGACCACCGAGATCTACACCTTGTGAGACACTCTTTCCCTACACGACGCTCTTCCGATCT
F061-ACTGCACA	AATGATACGGCGACCACCGAGATCTACACACTGCACAACACTCTTTCCCTACACGACGCTCTTCCGATCT
F062-CAACACTC	AATGATACGGCGACCACCGAGATCTACACCAACACTCACACTCTTTCCCTACACGACGCTCTTCCGATCT
F063-TACGTGGA	AATGATACGGCGACCACCGAGATCTACACTACGTGGAACACTCTTTCCCTACACGACGCTCTTCCGATCT
F064-GTGAGTTG	AATGATACGGCGACCACCGAGATCTACACGTGAGTTGACACTCTTTCCCTACACGACGCTCTTCCGATCT
F065-TGAGTCCT	AATGATACGGCGACCACCGAGATCTACACTGAGTCCTACACTCTTTCCCTACACGACGCTCTTCCGATCT
F066-CACTCCAA	AATGATACGGCGACCACCGAGATCTACACCACTCCAAACACTCTTTCCCTACACGACGCTCTTCCGATCT
F067-AGGACTGT	AATGATACGGCGACCACCGAGATCTACACAGGACTGTACACTCTTTCCCTACACGACGCTCTTCCGATCT
F068-GAGTGTGA	AATGATACGGCGACCACCGAGATCTACACGAGTGTGAACACTCTTTCCCTACACGACGCTCTTCCGATCT
F069-TGTTGCTG	AATGATACGGCGACCACCGAGATCTACACTGTTGCTGACACTCTTTCCCTACACGACGCTCTTCCGATCT
F070-ACAGAAGC	AATGATACGGCGACCACCGAGATCTACACACAGAAGCACACTCTTTCCCTACACGACGCTCTTCCGATCT
F071-CTCCAGTT	AATGATACGGCGACCACCGAGATCTACACCTCCAGTTACACTCTTTCCCTACACGACGCTCTTCCGATCT
F072-TAGACTAC	AATGATACGGCGACCACCGAGATCTACACTAGACTACACACTCTTTCCCTACACGACGCTCTTCCGATCT
F073-TTGTGAAG	AATGATACGGCGACCACCGAGATCTACACTTGTGAAGACACTCTTTCCCTACACGACGCTCTTCCGATCT
F074-TACACAGC	AATGATACGGCGACCACCGAGATCTACACTACACAGCACACTCTTTCCCTACACGACGCTCTTCCGATCT
F075-CTTGCATC	AATGATACGGCGACCACCGAGATCTACACCTTGCATCACACTCTTTCCCTACACGACGCTCTTCCGATCT
F076-CGTGTTCT	AATGATACGGCGACCACCGAGATCTACACCGTGTTCTACACTCTTTCCCTACACGACGCTCTTCCGATCT
F077-TCGTTCGA	AATGATACGGCGACCACCGAGATCTACACTCGTTCGAACACTCTTTCCCTACACGACGCTCTTCCGATCT
F078-GTTCTGTG	AATGATACGGCGACCACCGAGATCTACACGTTCTGTGACACTCTTTCCCTACACGACGCTCTTCCGATCT
F079-AACCACGA	AATGATACGGCGACCACCGAGATCTACACAACCACGAACACTCTTTCCCTACACGACGCTCTTCCGATCT
F080-ACAACTCA	AATGATACGGCGACCACCGAGATCTACACACAACTCAACACTCTTTCCCTACACGACGCTCTTCCGATCT
F081-TGAAGCAC	AATGATACGGCGACCACCGAGATCTACACTGAAGCACACACTCTTTCCCTACACGACGCTCTTCCGATCT
F082-TAGGATGG	AATGATACGGCGACCACCGAGATCTACACTAGGATGGACACTCTTTCCCTACACGACGCTCTTCCGATCT
F083-CTGAGACT	AATGATACGGCGACCACCGAGATCTACACCTGAGACTACACTCTTTCCCTACACGACGCTCTTCCGATCT
F084-GTCACAGA	AATGATACGGCGACCACCGAGATCTACACGTCACAGAACACTCTTTCCCTACACGACGCTCTTCCGATCT
F085-TCTGTCAA	AATGATACGGCGACCACCGAGATCTACACTCTGTCAAACACTCTTTCCCTACACGACGCTCTTCCGATCT
F086-ACAGGTTG	AATGATACGGCGACCACCGAGATCTACACACAGGTTGACACTCTTTCCCTACACGACGCTCTTCCGATCT
F087-GTCTAGAG	AATGATACGGCGACCACCGAGATCTACACGTCTAGAGACACTCTTTCCCTACACGACGCTCTTCCGATCT
F088-CACCTTGA	AATGATACGGCGACCACCGAGATCTACACCACCTTGAACACTCTTTCCCTACACGACGCTCTTCCGATCT
F089-ACCTGTCA	AATGATACGGCGACCACCGAGATCTACACACCTGTCAACACTCTTTCCCTACACGACGCTCTTCCGATCT
F090-TCACGAGT	AATGATACGGCGACCACCGAGATCTACACTCACGAGTACACTCTTTCCCTACACGACGCTCTTCCGATCT
F091-GAACCTCA	AATGATACGGCGACCACCGAGATCTACACGAACCTCAACACTCTTTCCCTACACGACGCTCTTCCGATCT
F092-CATCAAGT	AATGATACGGCGACCACCGAGATCTACACCATCAAGTACACTCTTTCCCTACACGACGCTCTTCCGATCT
F093-CATGTCGA	AATGATACGGCGACCACCGAGATCTACACCATGTCGAACACTCTTTCCCTACACGACGCTCTTCCGATCT
F094-AGCTCCTT	AATGATACGGCGACCACCGAGATCTACACAGCTCCTTACACTCTTTCCCTACACGACGCTCTTCCGATCT
F095-TTGGTGTC	AATGATACGGCGACCACCGAGATCTACACTTGGTGTCACACTCTTTCCCTACACGACGCTCTTCCGATCT
F096-ATGACTAG	AATGATACGGCGACCACCGAGATCTACACATGACTAGACACTCTTTCCCTACACGACGCTCTTCCGATCT
F097-GAAGTTGA	AATGATACGGCGACCACCGAGATCTACACGAAGTTGAACACTCTTTCCCTACACGACGCTCTTCCGATCT
F098-CAGATCCA	AATGATACGGCGACCACCGAGATCTACACCAGATCCAACACTCTTTCCCTACACGACGCTCTTCCGATCT
F099-ATCCATCG	AATGATACGGCGACCACCGAGATCTACACATCCATCGACACTCTTTCCCTACACGACGCTCTTCCGATCT
F100-CTCTACAC	AATGATACGGCGACCACCGAGATCTACACCTCTACACACACTCTTTCCCTACACGACGCTCTTCCGATCT
F101-TACAGATG	AATGATACGGCGACCACCGAGATCTACACTACAGATGACACTCTTTCCCTACACGACGCTCTTCCGATCT
F102-GGACAGTT	AATGATACGGCGACCACCGAGATCTACACGGACAGTTACACTCTTTCCCTACACGACGCTCTTCCGATCT
F103-TCTCCAAC	AATGATACGGCGACCACCGAGATCTACACTCTCCAACACACTCTTTCCCTACACGACGCTCTTCCGATCT
F104-TGTACTGA	AATGATACGGCGACCACCGAGATCTACACTGTACTGAACACTCTTTCCCTACACGACGCTCTTCCGATCT
F105-ACATCGTA	AATGATACGGCGACCACCGAGATCTACACACATCGTAACACTCTTTCCCTACACGACGCTCTTCCGATCT
F106-TGCAACAG	AATGATACGGCGACCACCGAGATCTACACTGCAACAGACACTCTTTCCCTACACGACGCTCTTCCGATCT
F107-TACTGTAG	AATGATACGGCGACCACCGAGATCTACACTACTGTAGACACTCTTTCCCTACACGACGCTCTTCCGATCT
F108-CAACAGCT	AATGATACGGCGACCACCGAGATCTACACCAACAGCTACACTCTTTCCCTACACGACGCTCTTCCGATCT
F109-ATGATCGA	AATGATACGGCGACCACCGAGATCTACACATGATCGAACACTCTTTCCCTACACGACGCTCTTCCGATCT
F110-GTCCATGA	AATGATACGGCGACCACCGAGATCTACACGTCCATGAACACTCTTTCCCTACACGACGCTCTTCCGATCT
F111-CATGGTTG	AATGATACGGCGACCACCGAGATCTACACCATGGTTGACACTCTTTCCCTACACGACGCTCTTCCGATCT
F112-TCGAGAAC	AATGATACGGCGACCACCGAGATCTACACTCGAGAACACACTCTTTCCCTACACGACGCTCTTCCGATCT
F113-ATCGTCTT	AATGATACGGCGACCACCGAGATCTACACATCGTCTTACACTCTTTCCCTACACGACGCTCTTCCGATCT
F114-TGACAACT	AATGATACGGCGACCACCGAGATCTACACTGACAACTACACTCTTTCCCTACACGACGCTCTTCCGATCT
F115-TCATCTCC	AATGATACGGCGACCACCGAGATCTACACTCATCTCCACACTCTTTCCCTACACGACGCTCTTCCGATCT
F116-GATGGTCA	AATGATACGGCGACCACCGAGATCTACACGATGGTCAACACTCTTTCCCTACACGACGCTCTTCCGATCT
F117-GATCTCAG	AATGATACGGCGACCACCGAGATCTACACGATCTCAGACACTCTTTCCCTACACGACGCTCTTCCGATCT
F118-CTGATGTG	AATGATACGGCGACCACCGAGATCTACACCTGATGTGACACTCTTTCCCTACACGACGCTCTTCCGATCT
F119-TGAGAAGG	AATGATACGGCGACCACCGAGATCTACACTGAGAAGGACACTCTTTCCCTACACGACGCTCTTCCGATCT
F120-ACCTACAA	AATGATACGGCGACCACCGAGATCTACACACCTACAAACACTCTTTCCCTACACGACGCTCTTCCGATCT
F121-CCACAGTA	AATGATACGGCGACCACCGAGATCTACACCCACAGTAACACTCTTTCCCTACACGACGCTCTTCCGATCT
F122-TGCTCTCA	AATGATACGGCGACCACCGAGATCTACACTGCTCTCAACACTCTTTCCCTACACGACGCTCTTCCGATCT
F123-GTTCCTAC	AATGATACGGCGACCACCGAGATCTACACGTTCCTACACACTCTTTCCCTACACGACGCTCTTCCGATCT
F124-CTAGGAGA	AATGATACGGCGACCACCGAGATCTACACCTAGGAGAACACTCTTTCCCTACACGACGCTCTTCCGATCT
F125-ATGTCCAC	AATGATACGGCGACCACCGAGATCTACACATGTCCACACACTCTTTCCCTACACGACGCTCTTCCGATCT
F126-AAGCTTGC	AATGATACGGCGACCACCGAGATCTACACAAGCTTGCACACTCTTTCCCTACACGACGCTCTTCCGATCT
F127-TAGATCTG	AATGATACGGCGACCACCGAGATCTACACTAGATCTGACACTCTTTCCCTACACGACGCTCTTCCGATCT
F128-CCTAGCAT	AATGATACGGCGACCACCGAGATCTACACCCTAGCATACACTCTTTCCCTACACGACGCTCTTCCGATCT
F129-GCATCATG	AATGATACGGCGACCACCGAGATCTACACGCATCATGACACTCTTTCCCTACACGACGCTCTTCCGATCT
F130-CTCAACGT	AATGATACGGCGACCACCGAGATCTACACCTCAACGTACACTCTTTCCCTACACGACGCTCTTCCGATCT
F131-AAGCTCAA	AATGATACGGCGACCACCGAGATCTACACAAGCTCAAACACTCTTTCCCTACACGACGCTCTTCCGATCT
F132-TGTAGTTC	AATGATACGGCGACCACCGAGATCTACACTGTAGTTCACACTCTTTCCCTACACGACGCTCTTCCGATCT
F133-AAGGTCCT	AATGATACGGCGACCACCGAGATCTACACAAGGTCCTACACTCTTTCCCTACACGACGCTCTTCCGATCT
F134-ACTTCAGC	AATGATACGGCGACCACCGAGATCTACACACTTCAGCACACTCTTTCCCTACACGACGCTCTTCCGATCT
F135-GGATCACA	AATGATACGGCGACCACCGAGATCTACACGGATCACAACACTCTTTCCCTACACGACGCTCTTCCGATCT
F136-GGAAGGAA	AATGATACGGCGACCACCGAGATCTACACGGAAGGAAACACTCTTTCCCTACACGACGCTCTTCCGATCT
F137-AGTGCTAG	AATGATACGGCGACCACCGAGATCTACACAGTGCTAGACACTCTTTCCCTACACGACGCTCTTCCGATCT
F138-AACAGGTC	AATGATACGGCGACCACCGAGATCTACACAACAGGTCACACTCTTTCCCTACACGACGCTCTTCCGATCT
F139-CTCATCTA	AATGATACGGCGACCACCGAGATCTACACCTCATCTAACACTCTTTCCCTACACGACGCTCTTCCGATCT
F140-CACTAGTG	AATGATACGGCGACCACCGAGATCTACACCACTAGTGACACTCTTTCCCTACACGACGCTCTTCCGATCT
F141-TCACATCG	AATGATACGGCGACCACCGAGATCTACACTCACATCGACACTCTTTCCCTACACGACGCTCTTCCGATCT
F142-GTACAAGC	AATGATACGGCGACCACCGAGATCTACACGTACAAGCACACTCTTTCCCTACACGACGCTCTTCCGATCT
F143-CAGTGGAT	AATGATACGGCGACCACCGAGATCTACACCAGTGGATACACTCTTTCCCTACACGACGCTCTTCCGATCT
F144-GGAAGAGT	AATGATACGGCGACCACCGAGATCTACACGGAAGAGTACACTCTTTCCCTACACGACGCTCTTCCGATCT
F145-GTACCTTG	AATGATACGGCGACCACCGAGATCTACACGTACCTTGACACTCTTTCCCTACACGACGCTCTTCCGATCT
F146-TAGGTGAT	AATGATACGGCGACCACCGAGATCTACACTAGGTGATACACTCTTTCCCTACACGACGCTCTTCCGATCT
F147-TCGTACAC	AATGATACGGCGACCACCGAGATCTACACTCGTACACACACTCTTTCCCTACACGACGCTCTTCCGATCT
F148-CTTGAGCA	AATGATACGGCGACCACCGAGATCTACACCTTGAGCAACACTCTTTCCCTACACGACGCTCTTCCGATCT
F149-GGTTGAGA	AATGATACGGCGACCACCGAGATCTACACGGTTGAGAACACTCTTTCCCTACACGACGCTCTTCCGATCT
F150-ACAACAAC	AATGATACGGCGACCACCGAGATCTACACACAACAACACACTCTTTCCCTACACGACGCTCTTCCGATCT
F151-AGCATCTG	AATGATACGGCGACCACCGAGATCTACACAGCATCTGACACTCTTTCCCTACACGACGCTCTTCCGATCT
F152-AACATCGT	AATGATACGGCGACCACCGAGATCTACACAACATCGTACACTCTTTCCCTACACGACGCTCTTCCGATCT
F153-GCTCTCTT	AATGATACGGCGACCACCGAGATCTACACGCTCTCTTACACTCTTTCCCTACACGACGCTCTTCCGATCT
F154-AGAGGTAC	AATGATACGGCGACCACCGAGATCTACACAGAGGTACACACTCTTTCCCTACACGACGCTCTTCCGATCT
F155-TCTCACAG	AATGATACGGCGACCACCGAGATCTACACTCTCACAGACACTCTTTCCCTACACGACGCTCTTCCGATCT
F156-TCCACTTG	AATGATACGGCGACCACCGAGATCTACACTCCACTTGACACTCTTTCCCTACACGACGCTCTTCCGATCT
F157-TGTTGGAC	AATGATACGGCGACCACCGAGATCTACACTGTTGGACACACTCTTTCCCTACACGACGCTCTTCCGATCT
F158-CGAACTCT	AATGATACGGCGACCACCGAGATCTACACCGAACTCTACACTCTTTCCCTACACGACGCTCTTCCGATCT
F159-ATGAACTC	AATGATACGGCGACCACCGAGATCTACACATGAACTCACACTCTTTCCCTACACGACGCTCTTCCGATCT
F160-GAACGAGA	AATGATACGGCGACCACCGAGATCTACACGAACGAGAACACTCTTTCCCTACACGACGCTCTTCCGATCT
F161-AACCAACC	AATGATACGGCGACCACCGAGATCTACACAACCAACCACACTCTTTCCCTACACGACGCTCTTCCGATCT
F162-TGATCGTT	AATGATACGGCGACCACCGAGATCTACACTGATCGTTACACTCTTTCCCTACACGACGCTCTTCCGATCT
F163-ACCTTGGA	AATGATACGGCGACCACCGAGATCTACACACCTTGGAACACTCTTTCCCTACACGACGCTCTTCCGATCT
F164-CGTACTTG	AATGATACGGCGACCACCGAGATCTACACCGTACTTGACACTCTTTCCCTACACGACGCTCTTCCGATCT
F165-TAGAGTGT	AATGATACGGCGACCACCGAGATCTACACTAGAGTGTACACTCTTTCCCTACACGACGCTCTTCCGATCT
F166-AGATGCTC	AATGATACGGCGACCACCGAGATCTACACAGATGCTCACACTCTTTCCCTACACGACGCTCTTCCGATCT
F167-GCTGAGAT	AATGATACGGCGACCACCGAGATCTACACGCTGAGATACACTCTTTCCCTACACGACGCTCTTCCGATCT
F168-GTTGCTGA	AATGATACGGCGACCACCGAGATCTACACGTTGCTGAACACTCTTTCCCTACACGACGCTCTTCCGATCT
F169-GGATGAAC	AATGATACGGCGACCACCGAGATCTACACGGATGAACACACTCTTTCCCTACACGACGCTCTTCCGATCT
F170-GCAGTGTA	AATGATACGGCGACCACCGAGATCTACACGCAGTGTAACACTCTTTCCCTACACGACGCTCTTCCGATCT
F171-ACGAACAG	AATGATACGGCGACCACCGAGATCTACACACGAACAGACACTCTTTCCCTACACGACGCTCTTCCGATCT
F172-TGAGGTGT	AATGATACGGCGACCACCGAGATCTACACTGAGGTGTACACTCTTTCCCTACACGACGCTCTTCCGATCT
F173-CACTGTCT	AATGATACGGCGACCACCGAGATCTACACCACTGTCTACACTCTTTCCCTACACGACGCTCTTCCGATCT
F174-ATGGTACC	AATGATACGGCGACCACCGAGATCTACACATGGTACCACACTCTTTCCCTACACGACGCTCTTCCGATCT
F175-ATGTCAGT	AATGATACGGCGACCACCGAGATCTACACATGTCAGTACACTCTTTCCCTACACGACGCTCTTCCGATCT
F176-CATCTGTA	AATGATACGGCGACCACCGAGATCTACACCATCTGTAACACTCTTTCCCTACACGACGCTCTTCCGATCT
F177-GGTTCGAA	AATGATACGGCGACCACCGAGATCTACACGGTTCGAAACACTCTTTCCCTACACGACGCTCTTCCGATCT
F178-ATGCTCTG	AATGATACGGCGACCACCGAGATCTACACATGCTCTGACACTCTTTCCCTACACGACGCTCTTCCGATCT
F179-GTCGTACT	AATGATACGGCGACCACCGAGATCTACACGTCGTACTACACTCTTTCCCTACACGACGCTCTTCCGATCT
F180-CGAGACTT	AATGATACGGCGACCACCGAGATCTACACCGAGACTTACACTCTTTCCCTACACGACGCTCTTCCGATCT
F181-TACTCTGT	AATGATACGGCGACCACCGAGATCTACACTACTCTGTACACTCTTTCCCTACACGACGCTCTTCCGATCT
F182-GAGAGAAG	AATGATACGGCGACCACCGAGATCTACACGAGAGAAGACACTCTTTCCCTACACGACGCTCTTCCGATCT
F183-TTCCTAGC	AATGATACGGCGACCACCGAGATCTACACTTCCTAGCACACTCTTTCCCTACACGACGCTCTTCCGATCT
F184-TCGTGGAA	AATGATACGGCGACCACCGAGATCTACACTCGTGGAAACACTCTTTCCCTACACGACGCTCTTCCGATCT
F185-ACACAACA	AATGATACGGCGACCACCGAGATCTACACACACAACAACACTCTTTCCCTACACGACGCTCTTCCGATCT
F186-TAGCTCGT	AATGATACGGCGACCACCGAGATCTACACTAGCTCGTACACTCTTTCCCTACACGACGCTCTTCCGATCT
F187-TCGTAGTG	AATGATACGGCGACCACCGAGATCTACACTCGTAGTGACACTCTTTCCCTACACGACGCTCTTCCGATCT
F188-GAAGCTTC	AATGATACGGCGACCACCGAGATCTACACGAAGCTTCACACTCTTTCCCTACACGACGCTCTTCCGATCT
F189-AGTGAGGT	AATGATACGGCGACCACCGAGATCTACACAGTGAGGTACACTCTTTCCCTACACGACGCTCTTCCGATCT
F190-GCTAGTAC	AATGATACGGCGACCACCGAGATCTACACGCTAGTACACACTCTTTCCCTACACGACGCTCTTCCGATCT
F191-GAACCAAC	AATGATACGGCGACCACCGAGATCTACACGAACCAACACACTCTTTCCCTACACGACGCTCTTCCGATCT
F192-CTCTCTAG	AATGATACGGCGACCACCGAGATCTACACCTCTCTAGACACTCTTTCCCTACACGACGCTCTTCCGATCT
