R001-TTGCAGGT	CAAGCAGAAGACGGCATACGAGATTTGCAGGTGTGACTGGAGTTCAGACGTGTGCTCTTCCGATCT
R002-CAAGGAAC	CAAGCAGAAGACGGCATACGAGATCAAGGAACGTGACTGGAGTTCAGACGTGTGCTCTTCCGATCT
R003-AGATCTGG	CAAGCAGAAGACGGCATACGAGATAGATCTGGGTGACTGGAGTTCAGACGTGTGCTCTTCCGATCT
R004-TCACACTT	CAAGCAGAAGACGGCATACGAGATTCACACTTGTGACTGGAGTTCAGACGTGTGCTCTTCCGATCT
R005-GATCATGG	CAAGCAGAAGACGGCATACGAGATGATCATGGGTGACTGGAGTTCAGACGTGTGCTCTTCCGATCT
R006-AGACATGA	CAAGCAGAAGACGGCATACGAGATAGACATGAGTGACTGGAGTTCAGACGTGTGCTCTTCCGATCT
R007-ACCACGAA	CAAGCAGAAGACGGCATACGAGATACCACGAAGTGACTGGAGTTCAGACGTGTGCTCTTCCGATCT
R008-TACGTTCC	CAAGCAGAAGACGGCATACGAGATTACGTTCCGTGACTGGAGTTCAGACGTGTGCTCTTCCGATCT
R009-GACTGACA	CAAGCAGAAGACGGCATACGAGATGACTGACAGTGACTGGAGTTCAGACGTGTGCTCTTCCGATCT
R010-GTGATCTT	CAAGCAGAAGACGGCATACGAGATGTGATCTTGTGACTGGAGTTCAGACGTGTGCTCTTCCGATCT
R011-CGTTCAAC	CAAGCAGAAGACGGCATACGAGATCGTTCAACGTGACTGGAGTTCAGACGTGTGCTCTTCCGATCT
R012-CTGACCAA	CAAGCAGAAGACGGCATACGAGATCTGACCAAGTGACTGGAGTTCAGACGTGTGCTCTTCCGATCT
R013-GTGAGTTG	CAAGCAGAAGACGGCATACGAGATGTGAGTTGGTGACTGGAGTTCAGACGTGTGCTCTTCCGATCT
R014-AGTCTGTT	CAAGCAGAAGACGGCATACGAGATAGTCTGTTGTGACTGGAGTTCAGACGTGTGCTCTTCCGATCT
R015-AACCAACC	CAAGCAGAAGACGGCATACGAGATAACCAACCGTGACTGGAGTTCAGACGTGTGCTCTTCCGATCT
R016-AGTGTGCA	CAAGCAGAAGACGGCATACGAGATAGTGTGCAGTGACTGGAGTTCAGACGTGTGCTCTTCCGATCT
R017-CATGTCGA	CAAGCAGAAGACGGCATACGAGATCATGTCGAGTGACTGGAGTTCAGACGTGTGCTCTTCCGATCT
R018-CGAGACTT	CAAGCAGAAGACGGCATACGAGATCGAGACTTGTGACTGGAGTTCAGACGTGTGCTCTTCCGATCT
R019-GCATCATG	CAAGCAGAAGACGGCATACGAGATGCATCATGGTGACTGGAGTTCAGACGTGTGCTCTTCCGATCT
R020-CACTTGGT	CAAGCAGAAGACGGCATACGAGATCACTTGGTGTGACTGGAGTTCAGACGTGTGCTCTTCCGATCT
R021-GTGTGCAA	CAAGCAGAAGACGGCATACGAGATGTGTGCAAGTGACTGGAGTTCAGACGTGTGCTCTTCCGATCT
R022-TCTCCAAC	CAAGCAGAAGACGGCATACGAGATTCTCCAACGTGACTGGAGTTCAGACGTGTGCTCTTCCGATCT
R023-GTGACAAC	CAAGCAGAAGACGGCATACGAGATGTGACAACGTGACTGGAGTTCAGACGTGTGCTCTTCCGATCT
R024-TCATGTGG	CAAGCAGAAGACGGCATACGAGATTCATGTGGGTGACTGGAGTTCAGACGTGTGCTCTTCCGATCT
R025-ATGGTGGT	CAAGCAGAAGACGGCATACGAGATATGGTGGTGTGACTGGAGTTCAGACGTGTGCTCTTCCGATCT
R026-AGTCGTTG	CAAGCAGAAGACGGCATACGAGATAGTCGTTGGTGACTGGAGTTCAGACGTGTGCTCTTCCGATCT
R027-CACCTTGA	CAAGCAGAAGACGGCATACGAGATCACCTTGAGTGACTGGAGTTCAGACGTGTGCTCTTCCGATCT
R028-CAACAGCT	CAAGCAGAAGACGGCATACGAGATCAACAGCTGTGACTGGAGTTCAGACGTGTGCTCTTCCGATCT
R029-TCAACCAT	CAAGCAGAAGACGGCATACGAGATTCAACCATGTGACTGGAGTTCAGACGTGTGCTCTTCCGATCT
R030-TTCATCCT	CAAGCAGAAGACGGCATACGAGATTTCATCCTGTGACTGGAGTTCAGACGTGTGCTCTTCCGATCT
R031-CTCACATG	CAAGCAGAAGACGGCATACGAGATCTCACATGGTGACTGGAGTTCAGACGTGTGCTCTTCCGATCT
R032-GTGTACTG	CAAGCAGAAGACGGCATACGAGATGTGTACTGGTGACTGGAGTTCAGACGTGTGCTCTTCCGATCT
R033-TACTCACG	CAAGCAGAAGACGGCATACGAGATTACTCACGGTGACTGGAGTTCAGACGTGTGCTCTTCCGATCT
R034-GAAGTACC	CAAGCAGAAGACGGCATACGAGATGAAGTACCGTGACTGGAGTTCAGACGTGTGCTCTTCCGATCT
R035-TCGAGAAC	CAAGCAGAAGACGGCATACGAGATTCGAGAACGTGACTGGAGTTCAGACGTGTGCTCTTCCGATCT
R036-GGTGAGTA	CAAGCAGAAGACGGCATACGAGATGGTGAGTAGTGACTGGAGTTCAGACGTGTGCTCTTCCGATCT
R037-GTCCATGA	CAAGCAGAAGACGGCATACGAGATGTCCATGAGTGACTGGAGTTCAGACGTGTGCTCTTCCGATCT
R038-TGGAGACA	CAAGCAGAAGACGGCATACGAGATTGGAGACAGTGACTGGAGTTCAGACGTGTGCTCTTCCGATCT
R039-AGTACACG	CAAGCAGAAGACGGCATACGAGATAGTACACGGTGACTGGAGTTCAGACGTGTGCTCTTCCGATCT
R040-TGATCGTT	CAAGCAGAAGACGGCATACGAGATTGATCGTTGTGACTGGAGTTCAGACGTGTGCTCTTCCGATCT
R041-GTTGGAGT	CAAGCAGAAGACGGCATACGAGATGTTGGAGTGTGACTGGAGTTCAGACGTGTGCTCTTCCGATCT
R042-CATGACAG	CAAGCAGAAGACGGCATACGAGATCATGACAGGTGACTGGAGTTCAGACGTGTGCTCTTCCGATCT
R043-TGTCGTCT	CAAGCAGAAGACGGCATACGAGATTGTCGTCTGTGACTGGAGTTCAGACGTGTGCTCTTCCGATCT
R044-TCAGTCTC	CAAGCAGAAGACGGCATACGAGATTCAGTCTCGTGACTGGAGTTCAGACGTGTGCTCTTCCGATCT
R045-ACCTGTCA	CAAGCAGAAGACGGCATACGAGATACCTGTCAGTGACTGGAGTTCAGACGTGTGCTCTTCCGATCT
R046-GAAGCTTC	CAAGCAGAAGACGGCATACGAGATGAAGCTTCGTGACTGGAGTTCAGACGTGTGCTCTTCCGATCT
R047-CTGCTGAT	CAAGCAGAAGACGGCATACGAGATCTGCTGATGTGACTGGAGTTCAGACGTGTGCTCTTCCGATCT
R048-ATGTCCAC	CAAGCAGAAGACGGCATACGAGATATGTCCACGTGACTGGAGTTCAGACGTGTGCTCTTCCGATCT
R049-ATCGACCA	CAAGCAGAAGACGGCATACGAGATATCGACCAGTGACTGGAGTTCAGACGTGTGCTCTTCCGATCT
R050-GTTCCTAC	CAAGCAGAAGACGGCATACGAGATGTTCCTACGTGACTGGAGTTCAGACGTGTGCTCTTCCGATCT
R051-CTTGAAGG	CAAGCAGAAGACGGCATACGAGATCTTGAAGGGTGACTGGAGTTCAGACGTGTGCTCTTCCGATCT
R052-ACACCTAG	CAAGCAGAAGACGGCATACGAGATACACCTAGGTGACTGGAGTTCAGACGTGTGCTCTTCCGATCT
R053-TGCAACAG	CAAGCAGAAGACGGCATACGAGATTGCAACAGGTGACTGGAGTTCAGACGTGTGCTCTTCCGATCT
R054-TCGTTCGA	CAAGCAGAAGACGGCATACGAGATTCGTTCGAGTGACTGGAGTTCAGACGTGTGCTCTTCCGATCT
R055-ACCACAGT	CAAGCAGAAGACGGCATACGAGATACCACAGTGTGACTGGAGTTCAGACGTGTGCTCTTCCGATCT
R056-CTTGCATC	CAAGCAGAAGACGGCATACGAGATCTTGCATCGTGACTGGAGTTCAGACGTGTGCTCTTCCGATCT
R057-TCTTGGTT	CAAGCAGAAGACGGCATACGAGATTCTTGGTTGTGACTGGAGTTCAGACGTGTGCTCTTCCGATCT
R058-GGATGTCT	CAAGCAGAAGACGGCATACGAGATGGATGTCTGTGACTGGAGTTCAGACGTGTGCTCTTCCGATCT
R059-CAAGTGTC	CAAGCAGAAGACGGCATACGAGATCAAGTGTCGTGACTGGAGTTCAGACGTGTGCTCTTCCGATCT
R060-AAGAAGGT	CAAGCAGAAGACGGCATACGAGATAAGAAGGTGTGACTGGAGTTCAGACGTGTGCTCTTCCGATCT
R061-TCGATGCA	CAAGCAGAAGACGGCATACGAGATTCGATGCAGTGACTGGAGTTCAGACGTGTGCTCTTCCGATCT
R062-GAGTGTGA	CAAGCAGAAGACGGCATACGAGATGAGTGTGAGTGACTGGAGTTCAGACGTGTGCTCTTCCGATCT
R063-CCTACGTT	CAAGCAGAAGACGGCATACGAGATCCTACGTTGTGACTGGAGTTCAGACGTGTGCTCTTCCGATCT
R064-GGAACTAC	CAAGCAGAAGACGGCATACGAGATGGAACTACGTGACTGGAGTTCAGACGTGTGCTCTTCCGATCT
R065-GTCTAGAG	CAAGCAGAAGACGGCATACGAGATGTCTAGAGGTGACTGGAGTTCAGACGTGTGCTCTTCCGATCT
R066-AGACTACC	CAAGCAGAAGACGGCATACGAGATAGACTACCGTGACTGGAGTTCAGACGTGTGCTCTTCCGATCT
R067-TCCACACA	CAAGCAGAAGACGGCATACGAGATTCCACACAGTGACTGGAGTTCAGACGTGTGCTCTTCCGATCT
R068-GAACGTAG	CAAGCAGAAGACGGCATACGAGATGAACGTAGGTGACTGGAGTTCAGACGTGTGCTCTTCCGATCT
R069-TAGGATGG	CAAGCAGAAGACGGCATACGAGATTAGGATGGGTGACTGGAGTTCAGACGTGTGCTCTTCCGATCT
R070-TCAGACGA	CAAGCAGAAGACGGCATACGAGATTCAGACGAGTGACTGGAGTTCAGACGTGTGCTCTTCCGATCT
R071-CTTGTGAG	CAAGCAGAAGACGGCATACGAGATCTTGTGAGGTGACTGGAGTTCAGACGTGTGCTCTTCCGATCT
R072-AAGCACTT	CAAGCAGAAGACGGCATACGAGATAAGCACTTGTGACTGGAGTTCAGACGTGTGCTCTTCCGATCT
R073-TCTGGTAG	CAAGCAGAAGACGGCATACGAGATTCTGGTAGGTGACTGGAGTTCAGACGTGTGCTCTTCCGATCT
R074-GATCTCAG	CAAGCAGAAGACGGCATACGAGATGATCTCAGGTGACTGGAGTTCAGACGTGTGCTCTTCCGATCT
R075-CAACCTGT	CAAGCAGAAGACGGCATACGAGATCAACCTGTGTGACTGGAGTTCAGACGTGTGCTCTTCCGATCT
R076-ATCTCACC	CAAGCAGAAGACGGCATACGAGATATCTCACCGTGACTGGAGTTCAGACGTGTGCTCTTCCGATCT
R077-ACAACTCA	CAAGCAGAAGACGGCATACGAGATACAACTCAGTGACTGGAGTTCAGACGTGTGCTCTTCCGATCT
R078-GTAGAGGT	CAAGCAGAAGACGGCATACGAGATGTAGAGGTGTGACTGGAGTTCAGACGTGTGCTCTTCCGATCT
R079-AGAGGACA	CAAGCAGAAGACGGCATACGAGATAGAGGACAGTGACTGGAGTTCAGACGTGTGCTCTTCCGATCT
R080-TGGATCAT	CAAGCAGAAGACGGCATACGAGATTGGATCATGTGACTGGAGTTCAGACGTGTGCTCTTCCGATCT
R081-TACTACTC	CAAGCAGAAGACGGCATACGAGATTACTACTCGTGACTGGAGTTCAGACGTGTGCTCTTCCGATCT
R082-CAGTGATG	CAAGCAGAAGACGGCATACGAGATCAGTGATGGTGACTGGAGTTCAGACGTGTGCTCTTCCGATCT
R083-GTCAAGCT	CAAGCAGAAGACGGCATACGAGATGTCAAGCTGTGACTGGAGTTCAGACGTGTGCTCTTCCGATCT
R084-TTCTGAGA	CAAGCAGAAGACGGCATACGAGATTTCTGAGAGTGACTGGAGTTCAGACGTGTGCTCTTCCGATCT
R085-GATGTGCT	CAAGCAGAAGACGGCATACGAGATGATGTGCTGTGACTGGAGTTCAGACGTGTGCTCTTCCGATCT
R086-TCGAACTA	CAAGCAGAAGACGGCATACGAGATTCGAACTAGTGACTGGAGTTCAGACGTGTGCTCTTCCGATCT
R087-ACGTCTGA	CAAGCAGAAGACGGCATACGAGATACGTCTGAGTGACTGGAGTTCAGACGTGTGCTCTTCCGATCT
R088-CATCGAAG	CAAGCAGAAGACGGCATACGAGATCATCGAAGGTGACTGGAGTTCAGACGTGTGCTCTTCCGATCT
R089-AGAACGAG	CAAGCAGAAGACGGCATACGAGATAGAACGAGGTGACTGGAGTTCAGACGTGTGCTCTTCCGATCT
R090-ACAGACCT	CAAGCAGAAGACGGCATACGAGATACAGACCTGTGACTGGAGTTCAGACGTGTGCTCTTCCGATCT
R091-CACAGTAC	CAAGCAGAAGACGGCATACGAGATCACAGTACGTGACTGGAGTTCAGACGTGTGCTCTTCCGATCT
R092-TTCCTAGC	CAAGCAGAAGACGGCATACGAGATTTCCTAGCGTGACTGGAGTTCAGACGTGTGCTCTTCCGATCT
R093-TGGTCAGA	CAAGCAGAAGACGGCATACGAGATTGGTCAGAGTGACTGGAGTTCAGACGTGTGCTCTTCCGATCT
R094-CTGATGTG	CAAGCAGAAGACGGCATACGAGATCTGATGTGGTGACTGGAGTTCAGACGTGTGCTCTTCCGATCT
R095-ACTGTCGT	CAAGCAGAAGACGGCATACGAGATACTGTCGTGTGACTGGAGTTCAGACGTGTGCTCTTCCGATCT
R096-GATGGTCA	CAAGCAGAAGACGGCATACGAGATGATGGTCAGTGACTGGAGTTCAGACGTGTGCTCTTCCGATCT
R097-GTTGTTCC	CAAGCAGAAGACGGCATACGAGATGTTGTTCCGTGACTGGAGTTCAGACGTGTGCTCTTCCGATCT
R098-TGTGACTC	CAAGCAGAAGACGGCATACGAGATTGTGACTCGTGACTGGAGTTCAGACGTGTGCTCTTCCGATCT
R099-TGTCAAGC	CAAGCAGAAGACGGCATACGAGATTGTCAAGCGTGACTGGAGTTCAGACGTGTGCTCTTCCGATCT
R100-ACACTCGA	CAAGCAGAAGACGGCATACGAGATACACTCGAGTGACTGGAGTTCAGACGTGTGCTCTTCCGATCT
R101-CAACTGAG	CAAGCAGAAGACGGCATACGAGATCAACTGAGGTGACTGGAGTTCAGACGTGTGCTCTTCCGATCT
R102-ACCTGATG	CAAGCAGAAGACGGCATACGAGATACCTGATGGTGACTGGAGTTCAGACGTGTGCTCTTCCGATCT
R103-GAAGCAGT	CAAGCAGAAGACGGCATACGAGATGAAGCAGTGTGACTGGAGTTCAGACGTGTGCTCTTCCGATCT
R104-CTGTACCT	CAAGCAGAAGACGGCATACGAGATCTGTACCTGTGACTGGAGTTCAGACGTGTGCTCTTCCGATCT
R105-AAGAGGAA	CAAGCAGAAGACGGCATACGAGATAAGAGGAAGTGACTGGAGTTCAGACGTGTGCTCTTCCGATCT
R106-TACACGTT	CAAGCAGAAGACGGCATACGAGATTACACGTTGTGACTGGAGTTCAGACGTGTGCTCTTCCGATCT
R107-TGACACAA	CAAGCAGAAGACGGCATACGAGATTGACACAAGTGACTGGAGTTCAGACGTGTGCTCTTCCGATCT
R108-AGTGCTAG	CAAGCAGAAGACGGCATACGAGATAGTGCTAGGTGACTGGAGTTCAGACGTGTGCTCTTCCGATCT
R109-TCCTGCAT	CAAGCAGAAGACGGCATACGAGATTCCTGCATGTGACTGGAGTTCAGACGTGTGCTCTTCCGATCT
R110-TGAGAGAT	CAAGCAGAAGACGGCATACGAGATTGAGAGATGTGACTGGAGTTCAGACGTGTGCTCTTCCGATCT
R111-CTAGTTCG	CAAGCAGAAGACGGCATACGAGATCTAGTTCGGTGACTGGAGTTCAGACGTGTGCTCTTCCGATCT
R112-GTCCTCAT	CAAGCAGAAGACGGCATACGAGATGTCCTCATGTGACTGGAGTTCAGACGTGTGCTCTTCCGATCT
R113-GATGAAGA	CAAGCAGAAGACGGCATACGAGATGATGAAGAGTGACTGGAGTTCAGACGTGTGCTCTTCCGATCT
R114-ACAACCTG	CAAGCAGAAGACGGCATACGAGATACAACCTGGTGACTGGAGTTCAGACGTGTGCTCTTCCGATCT
R115-ATGATCGA	CAAGCAGAAGACGGCATACGAGATATGATCGAGTGACTGGAGTTCAGACGTGTGCTCTTCCGATCT
R116-TGTGATCA	CAAGCAGAAGACGGCATACGAGATTGTGATCAGTGACTGGAGTTCAGACGTGTGCTCTTCCGATCT
R117-CTGTGTAC	CAAGCAGAAGACGGCATACGAGATCTGTGTACGTGACTGGAGTTCAGACGTGTGCTCTTCCGATCT
R118-TGCAAGGA	CAAGCAGAAGACGGCATACGAGATTGCAAGGAGTGACTGGAGTTCAGACGTGTGCTCTTCCGATCT
R119-AAGTCATC	CAAGCAGAAGACGGCATACGAGATAAGTCATCGTGACTGGAGTTCAGACGTGTGCTCTTCCGATCT
R120-GCACTTGT	CAAGCAGAAGACGGCATACGAGATGCACTTGTGTGACTGGAGTTCAGACGTGTGCTCTTCCGATCT
R121-TCATGCTA	CAAGCAGAAGACGGCATACGAGATTCATGCTAGTGACTGGAGTTCAGACGTGTGCTCTTCCGATCT
R122-TAGAGTGT	CAAGCAGAAGACGGCATACGAGATTAGAGTGTGTGACTGGAGTTCAGACGTGTGCTCTTCCGATCT
R123-ACACTGTG	CAAGCAGAAGACGGCATACGAGATACACTGTGGTGACTGGAGTTCAGACGTGTGCTCTTCCGATCT
R124-AACCAGAG	CAAGCAGAAGACGGCATACGAGATAACCAGAGGTGACTGGAGTTCAGACGTGTGCTCTTCCGATCT
R125-GTTGCTGA	CAAGCAGAAGACGGCATACGAGATGTTGCTGAGTGACTGGAGTTCAGACGTGTGCTCTTCCGATCT
R126-CAACTACA	CAAGCAGAAGACGGCATACGAGATCAACTACAGTGACTGGAGTTCAGACGTGTGCTCTTCCGATCT
R127-TGTCAGTG	CAAGCAGAAGACGGCATACGAGATTGTCAGTGGTGACTGGAGTTCAGACGTGTGCTCTTCCGATCT
R128-AGTACCAC	CAAGCAGAAGACGGCATACGAGATAGTACCACGTGACTGGAGTTCAGACGTGTGCTCTTCCGATCT
R129-GAAGTTGA	CAAGCAGAAGACGGCATACGAGATGAAGTTGAGTGACTGGAGTTCAGACGTGTGCTCTTCCGATCT
R130-ATGGTACC	CAAGCAGAAGACGGCATACGAGATATGGTACCGTGACTGGAGTTCAGACGTGTGCTCTTCCGATCT
R131-TTGAGGTT	CAAGCAGAAGACGGCATACGAGATTTGAGGTTGTGACTGGAGTTCAGACGTGTGCTCTTCCGATCT
R132-CTCTACAC	CAAGCAGAAGACGGCATACGAGATCTCTACACGTGACTGGAGTTCAGACGTGTGCTCTTCCGATCT
R133-CTTGAGCA	CAAGCAGAAGACGGCATACGAGATCTTGAGCAGTGACTGGAGTTCAGACGTGTGCTCTTCCGATCT
R134-CTGTTGGA	CAAGCAGAAGACGGCATACGAGATCTGTTGGAGTGACTGGAGTTCAGACGTGTGCTCTTCCGATCT
R135-ACAAGTGC	CAAGCAGAAGACGGCATACGAGATACAAGTGCGTGACTGGAGTTCAGACGTGTGCTCTTCCGATCT
R136-GGTACCTT	CAAGCAGAAGACGGCATACGAGATGGTACCTTGTGACTGGAGTTCAGACGTGTGCTCTTCCGATCT
R137-GATCTAGC	CAAGCAGAAGACGGCATACGAGATGATCTAGCGTGACTGGAGTTCAGACGTGTGCTCTTCCGATCT
R138-ATCTGTTC	CAAGCAGAAGACGGCATACGAGATATCTGTTCGTGACTGGAGTTCAGACGTGTGCTCTTCCGATCT
R139-TAGTCCAG	CAAGCAGAAGACGGCATACGAGATTAGTCCAGGTGACTGGAGTTCAGACGTGTGCTCTTCCGATCT
R140-TACCATGC	CAAGCAGAAGACGGCATACGAGATTACCATGCGTGACTGGAGTTCAGACGTGTGCTCTTCCGATCT
R141-AGGTTGAG	CAAGCAGAAGACGGCATACGAGATAGGTTGAGGTGACTGGAGTTCAGACGTGTGCTCTTCCGATCT
R142-GTGACTCT	CAAGCAGAAGACGGCATACGAGATGTGACTCTGTGACTGGAGTTCAGACGTGTGCTCTTCCGATCT
R143-TCAGTACG	CAAGCAGAAGACGGCATACGAGATTCAGTACGGTGACTGGAGTTCAGACGTGTGCTCTTCCGATCT
R144-TACAGATG	CAAGCAGAAGACGGCATACGAGATTACAGATGGTGACTGGAGTTCAGACGTGTGCTCTTCCGATCT
R145-TCTGAAGT	CAAGCAGAAGACGGCATACGAGATTCTGAAGTGTGACTGGAGTTCAGACGTGTGCTCTTCCGATCT
R146-ATGTGACA	CAAGCAGAAGACGGCATACGAGATATGTGACAGTGACTGGAGTTCAGACGTGTGCTCTTCCGATCT
R147-CCTACAAG	CAAGCAGAAGACGGCATACGAGATCCTACAAGGTGACTGGAGTTCAGACGTGTGCTCTTCCGATCT
R148-GTTCTCGA	CAAGCAGAAGACGGCATACGAGATGTTCTCGAGTGACTGGAGTTCAGACGTGTGCTCTTCCGATCT
R149-ATCGTCTT	CAAGCAGAAGACGGCATACGAGATATCGTCTTGTGACTGGAGTTCAGACGTGTGCTCTTCCGATCT
R150-AAGACGTG	CAAGCAGAAGACGGCATACGAGATAAGACGTGGTGACTGGAGTTCAGACGTGTGCTCTTCCGATCT
R151-GCATCGAT	CAAGCAGAAGACGGCATACGAGATGCATCGATGTGACTGGAGTTCAGACGTGTGCTCTTCCGATCT
R152-ACTCATCC	CAAGCAGAAGACGGCATACGAGATACTCATCCGTGACTGGAGTTCAGACGTGTGCTCTTCCGATCT
R153-GGATGAAC	CAAGCAGAAGACGGCATACGAGATGGATGAACGTGACTGGAGTTCAGACGTGTGCTCTTCCGATCT
R154-TGCATGTC	CAAGCAGAAGACGGCATACGAGATTGCATGTCGTGACTGGAGTTCAGACGTGTGCTCTTCCGATCT
R155-CGAAGTGA	CAAGCAGAAGACGGCATACGAGATCGAAGTGAGTGACTGGAGTTCAGACGTGTGCTCTTCCGATCT
R156-TACTCTGT	CAAGCAGAAGACGGCATACGAGATTACTCTGTGTGACTGGAGTTCAGACGTGTGCTCTTCCGATCT
R157-AGAACAGA	CAAGCAGAAGACGGCATACGAGATAGAACAGAGTGACTGGAGTTCAGACGTGTGCTCTTCCGATCT
R158-AGTCCAGT	CAAGCAGAAGACGGCATACGAGATAGTCCAGTGTGACTGGAGTTCAGACGTGTGCTCTTCCGATCT
R159-CTCCAGTT	CAAGCAGAAGACGGCATACGAGATCTCCAGTTGTGACTGGAGTTCAGACGTGTGCTCTTCCGATCT
R160-GACGTCAA	CAAGCAGAAGACGGCATACGAGATGACGTCAAGTGACTGGAGTTCAGACGTGTGCTCTTCCGATCT
R161-TCATCTCC	CAAGCAGAAGACGGCATACGAGATTCATCTCCGTGACTGGAGTTCAGACGTGTGCTCTTCCGATCT
R162-TGCTTCAA	CAAGCAGAAGACGGCATACGAGATTGCTTCAAGTGACTGGAGTTCAGACGTGTGCTCTTCCGATCT
R163-ACAAGGTT	CAAGCAGAAGACGGCATACGAGATACAAGGTTGTGACTGGAGTTCAGACGTGTGCTCTTCCGATCT
R164-CTACGTCA	CAAGCAGAAGACGGCATACGAGATCTACGTCAGTGACTGGAGTTCAGACGTGTGCTCTTCCGATCT
R165-ACTCTACT	CAAGCAGAAGACGGCATACGAGATACTCTACTGTGACTGGAGTTCAGACGTGTGCTCTTCCGATCT
R166-CACTAGTG	CAAGCAGAAGACGGCATACGAGATCACTAGTGGTGACTGGAGTTCAGACGTGTGCTCTTCCGATCT
R167-TTGGTGTC	CAAGCAGAAGACGGCATACGAGATTTGGTGTCGTGACTGGAGTTCAGACGTGTGCTCTTCCGATCT
R168-GAGAGAAG	CAAGCAGAAGACGGCATACGAGATGAGAGAAGGTGACTGGAGTTCAGACGTGTGCTCTTCCGATCT
R169-CTTCGTGT	CAAGCAGAAGACGGCATACGAGATCTTCGTGTGTGACTGGAGTTCAGACGTGTGCTCTTCCGATCT
R170-TGACTAGA	CAAGCAGAAGACGGCATACGAGATTGACTAGAGTGACTGGAGTTCAGACGTGTGCTCTTCCGATCT
R171-GTGAAGTA	CAAGCAGAAGACGGCATACGAGATGTGAAGTAGTGACTGGAGTTCAGACGTGTGCTCTTCCGATCT
R172-TGCAGCTT	CAAGCAGAAGACGGCATACGAGATTGCAGCTTGTGACTGGAGTTCAGACGTGTGCTCTTCCGATCT
R173-TTGTCGAT	CAAGCAGAAGACGGCATACGAGATTTGTCGATGTGACTGGAGTTCAGACGTGTGCTCTTCCGATCT
R174-CTAGGTTC	CAAGCAGAAGACGGCATACGAGATCTAGGTTCGTGACTGGAGTTCAGACGTGTGCTCTTCCGATCT
R175-ACATCACT	CAAGCAGAAGACGGCATACGAGATACATCACTGTGACTGGAGTTCAGACGTGTGCTCTTCCGATCT
R176-AACGTGAC	CAAGCAGAAGACGGCATACGAGATAACGTGACGTGACTGGAGTTCAGACGTGTGCTCTTCCGATCT
R177-GCTACCAA	CAAGCAGAAGACGGCATACGAGATGCTACCAAGTGACTGGAGTTCAGACGTGTGCTCTTCCGATCT
R178-TCACATCG	CAAGCAGAAGACGGCATACGAGATTCACATCGGTGACTGGAGTTCAGACGTGTGCTCTTCCGATCT
R179-AACGACTG	CAAGCAGAAGACGGCATACGAGATAACGACTGGTGACTGGAGTTCAGACGTGTGCTCTTCCGATCT
R180-ACTGGAAC	CAAGCAGAAGACGGCATACGAGATACTGGAACGTGACTGGAGTTCAGACGTGTGCTCTTCCGATCT
R181-GAACGAGA	CAAGCAGAAGACGGCATACGAGATGAACGAGAGTGACTGGAGTTCAGACGTGTGCTCTTCCGATCT
R182-AGACCTTC	CAAGCAGAAGACGGCATACGAGATAGACCTTCGTGACTGGAGTTCAGACGTGTGCTCTTCCGATCT
R183-AACCTGCT	CAAGCAGAAGACGGCATACGAGATAACCTGCTGTGACTGGAGTTCAGACGTGTGCTCTTCCGATCT
R184-CATGGTTG	CAAGCAGAAGACGGCATACGAGATCATGGTTGGTGACTGGAGTTCAGACGTGTGCTCTTCCGATCT
R185-TTCGTCAG	CAAGCAGAAGACGGCATACGAGATTTCGTCAGGTGACTGGAGTTCAGACGTGTGCTCTTCCGATCT
R186-TGTCCACA	CAAGCAGAAGACGGCATACGAGATTGTCCACAGTGACTGGAGTTCAGACGTGTGCTCTTCCGATCT
R187-TGAGGTGT	CAAGCAGAAGACGGCATACGAGATTGAGGTGTGTGACTGGAGTTCAGACGTGTGCTCTTCCGATCT
R188-CTGTAGTC	CAAGCAGAAGACGGCATACGAGATCTGTAGTCGTGACTGGAGTTCAGACGTGTGCTCTTCCGATCT
R189-GAGAACGA	CAAGCAGAAGACGGCATACGAGATGAGAACGAGTGACTGGAGTTCAGACGTGTGCTCTTCCGATCT
R190-GTCACAGA	CAAGCAGAAGACGGCATACGAGATGTCACAGAGTGACTGGAGTTCAGACGTGTGCTCTTCCGATCT
R191-TCGTAGTG	CAAGCAGAAGACGGCATACGAGATTCGTAGTGGTGACTGGAGTTCAGACGTGTGCTCTTCCGATCT
R192-ACCAGTAG	CAAGCAGAAGACGGCATACGAGATACCAGTAGGTGACTGGAGTTCAGACGTGTGCTCTTCCGATCT
R193-TCTCAGCT	CAAGCAGAAGACGGCATACGAGATTCTCAGCTGTGACTGGAGTTCAGACGTGTGCTCTTCCGATCT
R194-GGAAGGAA	CAAGCAGAAGACGGCATACGAGATGGAAGGAAGTGACTGGAGTTCAGACGTGTGCTCTTCCGATCT
R195-ACACGTCT	CAAGCAGAAGACGGCATACGAGATACACGTCTGTGACTGGAGTTCAGACGTGTGCTCTTCCGATCT
R196-ATCAAGTG	CAAGCAGAAGACGGCATACGAGATATCAAGTGGTGACTGGAGTTCAGACGTGTGCTCTTCCGATCT
R197-AGAGTCTA	CAAGCAGAAGACGGCATACGAGATAGAGTCTAGTGACTGGAGTTCAGACGTGTGCTCTTCCGATCT
R198-TCTTGACC	CAAGCAGAAGACGGCATACGAGATTCTTGACCGTGACTGGAGTTCAGACGTGTGCTCTTCCGATCT
R199-GTACAAGC	CAAGCAGAAGACGGCATACGAGATGTACAAGCGTGACTGGAGTTCAGACGTGTGCTCTTCCGATCT
R200-ACTCGTGA	CAAGCAGAAGACGGCATACGAGATACTCGTGAGTGACTGGAGTTCAGACGTGTGCTCTTCCGATCT
R201-TAGGTGAT	CAAGCAGAAGACGGCATACGAGATTAGGTGATGTGACTGGAGTTCAGACGTGTGCTCTTCCGATCT
R202-CACTCCAA	CAAGCAGAAGACGGCATACGAGATCACTCCAAGTGACTGGAGTTCAGACGTGTGCTCTTCCGATCT
R203-TGGTCTTG	CAAGCAGAAGACGGCATACGAGATTGGTCTTGGTGACTGGAGTTCAGACGTGTGCTCTTCCGATCT
R204-CAGACAGT	CAAGCAGAAGACGGCATACGAGATCAGACAGTGTGACTGGAGTTCAGACGTGTGCTCTTCCGATCT
R205-AAGACCAT	CAAGCAGAAGACGGCATACGAGATAAGACCATGTGACTGGAGTTCAGACGTGTGCTCTTCCGATCT
R206-GTCAACAA	CAAGCAGAAGACGGCATACGAGATGTCAACAAGTGACTGGAGTTCAGACGTGTGCTCTTCCGATCT
R207-AACCTAGG	CAAGCAGAAGACGGCATACGAGATAACCTAGGGTGACTGGAGTTCAGACGTGTGCTCTTCCGATCT
R208-CAACCATG	CAAGCAGAAGACGGCATACGAGATCAACCATGGTGACTGGAGTTCAGACGTGTGCTCTTCCGATCT
R209-GTCACTTC	CAAGCAGAAGACGGCATACGAGATGTCACTTCGTGACTGGAGTTCAGACGTGTGCTCTTCCGATCT
R210-CTAGGAGA	CAAGCAGAAGACGGCATACGAGATCTAGGAGAGTGACTGGAGTTCAGACGTGTGCTCTTCCGATCT
R211-AGGTGCAT	CAAGCAGAAGACGGCATACGAGATAGGTGCATGTGACTGGAGTTCAGACGTGTGCTCTTCCGATCT
R212-TCTCTGTC	CAAGCAGAAGACGGCATACGAGATTCTCTGTCGTGACTGGAGTTCAGACGTGTGCTCTTCCGATCT
R213-GGTTGAGA	CAAGCAGAAGACGGCATACGAGATGGTTGAGAGTGACTGGAGTTCAGACGTGTGCTCTTCCGATCT
R214-TCTGCTCT	CAAGCAGAAGACGGCATACGAGATTCTGCTCTGTGACTGGAGTTCAGACGTGTGCTCTTCCGATCT
R215-CACTGTCT	CAAGCAGAAGACGGCATACGAGATCACTGTCTGTGACTGGAGTTCAGACGTGTGCTCTTCCGATCT
R216-CCACAGTA	CAAGCAGAAGACGGCATACGAGATCCACAGTAGTGACTGGAGTTCAGACGTGTGCTCTTCCGATCT
R217-GACTGCTT	CAAGCAGAAGACGGCATACGAGATGACTGCTTGTGACTGGAGTTCAGACGTGTGCTCTTCCGATCT
R218-GTGCTACA	CAAGCAGAAGACGGCATACGAGATGTGCTACAGTGACTGGAGTTCAGACGTGTGCTCTTCCGATCT
R219-GTACACAG	CAAGCAGAAGACGGCATACGAGATGTACACAGGTGACTGGAGTTCAGACGTGTGCTCTTCCGATCT
R220-TGAGAAGG	CAAGCAGAAGACGGCATACGAGATTGAGAAGGGTGACTGGAGTTCAGACGTGTGCTCTTCCGATCT
R221-ACCTCTAC	CAAGCAGAAGACGGCATACGAGATACCTCTACGTGACTGGAGTTCAGACGTGTGCTCTTCCGATCT
R222-ACAAGACG	CAAGCAGAAGACGGCATACGAGATACAAGACGGTGACTGGAGTTCAGACGTGTGCTCTTCCGATCT
R223-TAGAAGTC	CAAGCAGAAGACGGCATACGAGATTAGAAGTCGTGACTGGAGTTCAGACGTGTGCTCTTCCGATCT
R224-AGCTGGAA	CAAGCAGAAGACGGCATACGAGATAGCTGGAAGTGACTGGAGTTCAGACGTGTGCTCTTCCGATCT
R225-CATGGACT	CAAGCAGAAGACGGCATACGAGATCATGGACTGTGACTGGAGTTCAGACGTGTGCTCTTCCGATCT
R226-ACGTACGT	CAAGCAGAAGACGGCATACGAGATACGTACGTGTGACTGGAGTTCAGACGTGTGCTCTTCCGATCT
R227-TGAGTCCT	CAAGCAGAAGACGGCATACGAGATTGAGTCCTGTGACTGGAGTTCAGACGTGTGCTCTTCCGATCT
R228-CATCCTTC	CAAGCAGAAGACGGCATACGAGATCATCCTTCGTGACTGGAGTTCAGACGTGTGCTCTTCCGATCT
R229-TTGCTTGA	CAAGCAGAAGACGGCATACGAGATTTGCTTGAGTGACTGGAGTTCAGACGTGTGCTCTTCCGATCT
R230-CGATGTAG	CAAGCAGAAGACGGCATACGAGATCGATGTAGGTGACTGGAGTTCAGACGTGTGCTCTTCCGATCT
R231-GAACCTCA	CAAGCAGAAGACGGCATACGAGATGAACCTCAGTGACTGGAGTTCAGACGTGTGCTCTTCCGATCT
R232-AACGTACA	CAAGCAGAAGACGGCATACGAGATAACGTACAGTGACTGGAGTTCAGACGTGTGCTCTTCCGATCT
R233-GGACAGTT	CAAGCAGAAGACGGCATACGAGATGGACAGTTGTGACTGGAGTTCAGACGTGTGCTCTTCCGATCT
R234-CGATCAGT	CAAGCAGAAGACGGCATACGAGATCGATCAGTGTGACTGGAGTTCAGACGTGTGCTCTTCCGATCT
R235-AGCTCCTT	CAAGCAGAAGACGGCATACGAGATAGCTCCTTGTGACTGGAGTTCAGACGTGTGCTCTTCCGATCT
R236-ACGTCAAG	CAAGCAGAAGACGGCATACGAGATACGTCAAGGTGACTGGAGTTCAGACGTGTGCTCTTCCGATCT
R237-GCTAGTAC	CAAGCAGAAGACGGCATACGAGATGCTAGTACGTGACTGGAGTTCAGACGTGTGCTCTTCCGATCT
R238-TTCGAGAA	CAAGCAGAAGACGGCATACGAGATTTCGAGAAGTGACTGGAGTTCAGACGTGTGCTCTTCCGATCT
R239-ACTAGCTC	CAAGCAGAAGACGGCATACGAGATACTAGCTCGTGACTGGAGTTCAGACGTGTGCTCTTCCGATCT
R240-GAGCTGTT	CAAGCAGAAGACGGCATACGAGATGAGCTGTTGTGACTGGAGTTCAGACGTGTGCTCTTCCGATCT
R241-ACTACTGG	CAAGCAGAAGACGGCATACGAGATACTACTGGGTGACTGGAGTTCAGACGTGTGCTCTTCCGATCT
R242-CTGTTCAG	CAAGCAGAAGACGGCATACGAGATCTGTTCAGGTGACTGGAGTTCAGACGTGTGCTCTTCCGATCT
R243-CGAACTCT	CAAGCAGAAGACGGCATACGAGATCGAACTCTGTGACTGGAGTTCAGACGTGTGCTCTTCCGATCT
R244-TCAAGGAG	CAAGCAGAAGACGGCATACGAGATTCAAGGAGGTGACTGGAGTTCAGACGTGTGCTCTTCCGATCT
R245-GATGGATC	CAAGCAGAAGACGGCATACGAGATGATGGATCGTGACTGGAGTTCAGACGTGTGCTCTTCCGATCT
R246-TCTGTCAA	CAAGCAGAAGACGGCATACGAGATTCTGTCAAGTGACTGGAGTTCAGACGTGTGCTCTTCCGATCT
R247-TTCCAACA	CAAGCAGAAGACGGCATACGAGATTTCCAACAGTGACTGGAGTTCAGACGTGTGCTCTTCCGATCT
R248-TGAGTGTG	CAAGCAGAAGACGGCATACGAGATTGAGTGTGGTGACTGGAGTTCAGACGTGTGCTCTTCCGATCT
R249-CTACTAGT	CAAGCAGAAGACGGCATACGAGATCTACTAGTGTGACTGGAGTTCAGACGTGTGCTCTTCCGATCT
R250-CTGGACTA	CAAGCAGAAGACGGCATACGAGATCTGGACTAGTGACTGGAGTTCAGACGTGTGCTCTTCCGATCT
R251-GACAGGAT	CAAGCAGAAGACGGCATACGAGATGACAGGATGTGACTGGAGTTCAGACGTGTGCTCTTCCGATCT
R252-ACCTAGTC	CAAGCAGAAGACGGCATACGAGATACCTAGTCGTGACTGGAGTTCAGACGTGTGCTCTTCCGATCT
R253-TGGACGAA	CAAGCAGAAGACGGCATACGAGATTGGACGAAGTGACTGGAGTTCAGACGTGTGCTCTTCCGATCT
R254-TAGCTACC	CAAGCAGAAGACGGCATACGAGATTAGCTACCGTGACTGGAGTTCAGACGTGTGCTCTTCCGATCT
R255-GTTCTGTG	CAAGCAGAAGACGGCATACGAGATGTTCTGTGGTGACTGGAGTTCAGACGTGTGCTCTTCCGATCT
R256-ACTTCAGC	CAAGCAGAAGACGGCATACGAGATACTTCAGCGTGACTGGAGTTCAGACGTGTGCTCTTCCGATCT
R257-GTCAGTCA	CAAGCAGAAGACGGCATACGAGATGTCAGTCAGTGACTGGAGTTCAGACGTGTGCTCTTCCGATCT
R258-GTCTCGTT	CAAGCAGAAGACGGCATACGAGATGTCTCGTTGTGACTGGAGTTCAGACGTGTGCTCTTCCGATCT
R259-AGAGCATG	CAAGCAGAAGACGGCATACGAGATAGAGCATGGTGACTGGAGTTCAGACGTGTGCTCTTCCGATCT
R260-TCCAAGAC	CAAGCAGAAGACGGCATACGAGATTCCAAGACGTGACTGGAGTTCAGACGTGTGCTCTTCCGATCT
R261-CAAGTCAT	CAAGCAGAAGACGGCATACGAGATCAAGTCATGTGACTGGAGTTCAGACGTGTGCTCTTCCGATCT
R262-CCTAGCAT	CAAGCAGAAGACGGCATACGAGATCCTAGCATGTGACTGGAGTTCAGACGTGTGCTCTTCCGATCT
R263-AGTGTTGC	CAAGCAGAAGACGGCATACGAGATAGTGTTGCGTGACTGGAGTTCAGACGTGTGCTCTTCCGATCT
R264-AAGGAACG	CAAGCAGAAGACGGCATACGAGATAAGGAACGGTGACTGGAGTTCAGACGTGTGCTCTTCCGATCT
R265-TCACGAGT	CAAGCAGAAGACGGCATACGAGATTCACGAGTGTGACTGGAGTTCAGACGTGTGCTCTTCCGATCT
R266-CTTCACAT	CAAGCAGAAGACGGCATACGAGATCTTCACATGTGACTGGAGTTCAGACGTGTGCTCTTCCGATCT
R267-GACATGTA	CAAGCAGAAGACGGCATACGAGATGACATGTAGTGACTGGAGTTCAGACGTGTGCTCTTCCGATCT
R268-TCCAGTCT	CAAGCAGAAGACGGCATACGAGATTCCAGTCTGTGACTGGAGTTCAGACGTGTGCTCTTCCGATCT
R269-TACGAGCT	CAAGCAGAAGACGGCATACGAGATTACGAGCTGTGACTGGAGTTCAGACGTGTGCTCTTCCGATCT
R270-ATGGAAGA	CAAGCAGAAGACGGCATACGAGATATGGAAGAGTGACTGGAGTTCAGACGTGTGCTCTTCCGATCT
R271-AAGCTTGC	CAAGCAGAAGACGGCATACGAGATAAGCTTGCGTGACTGGAGTTCAGACGTGTGCTCTTCCGATCT
R272-CTCTCTAG	CAAGCAGAAGACGGCATACGAGATCTCTCTAGGTGACTGGAGTTCAGACGTGTGCTCTTCCGATCT
R273-TGATCAAG	CAAGCAGAAGACGGCATACGAGATTGATCAAGGTGACTGGAGTTCAGACGTGTGCTCTTCCGATCT
R274-GATCACCA	CAAGCAGAAGACGGCATACGAGATGATCACCAGTGACTGGAGTTCAGACGTGTGCTCTTCCGATCT
R275-CGTAGCTA	CAAGCAGAAGACGGCATACGAGATCGTAGCTAGTGACTGGAGTTCAGACGTGTGCTCTTCCGATCT
R276-AGTTCTCC	CAAGCAGAAGACGGCATACGAGATAGTTCTCCGTGACTGGAGTTCAGACGTGTGCTCTTCCGATCT
R277-CCTGATGA	CAAGCAGAAGACGGCATACGAGATCCTGATGAGTGACTGGAGTTCAGACGTGTGCTCTTCCGATCT
R278-GCTCTCTT	CAAGCAGAAGACGGCATACGAGATGCTCTCTTGTGACTGGAGTTCAGACGTGTGCTCTTCCGATCT
R279-TGTTGGAC	CAAGCAGAAGACGGCATACGAGATTGTTGGACGTGACTGGAGTTCAGACGTGTGCTCTTCCGATCT
R280-TCAACGTC	CAAGCAGAAGACGGCATACGAGATTCAACGTCGTGACTGGAGTTCAGACGTGTGCTCTTCCGATCT
R281-TACCACAT	CAAGCAGAAGACGGCATACGAGATTACCACATGTGACTGGAGTTCAGACGTGTGCTCTTCCGATCT
R282-AAGACACA	CAAGCAGAAGACGGCATACGAGATAAGACACAGTGACTGGAGTTCAGACGTGTGCTCTTCCGATCT
R283-ACATGGAC	CAAGCAGAAGACGGCATACGAGATACATGGACGTGACTGGAGTTCAGACGTGTGCTCTTCCGATCT
R284-ATCAGAGG	CAAGCAGAAGACGGCATACGAGATATCAGAGGGTGACTGGAGTTCAGACGTGTGCTCTTCCGATCT
R285-GTGGTGAA	CAAGCAGAAGACGGCATACGAGATGTGGTGAAGTGACTGGAGTTCAGACGTGTGCTCTTCCGATCT
R286-CTCGATCT	CAAGCAGAAGACGGCATACGAGATCTCGATCTGTGACTGGAGTTCAGACGTGTGCTCTTCCGATCT
R287-GTTCATCT	CAAGCAGAAGACGGCATACGAGATGTTCATCTGTGACTGGAGTTCAGACGTGTGCTCTTCCGATCT
R288-AGGAGATG	CAAGCAGAAGACGGCATACGAGATAGGAGATGGTGACTGGAGTTCAGACGTGTGCTCTTCCGATCT
